194 66 67 194 194 194 194 194 194 194 194 194 194 194 194 194 194 194 194 194 194 194 194 194 194 194 194 194 194 194 194 194
194 66 67 194 194 194 194 194 194 194 194 194 194 194 194 194 194 194 194 194 194 194 194 194 194 194 194 194 194 194 194 194
194 66 67 194 194 194 194 194 194 194 194 194 194 194 194 194 194 194 194 194 194 194 194 194 194 194 194 194 194 194 194 194
194 66 67 194 194 194 194 194 194 194 194 194 194 194 194 194 194 194 194 194 194 194 194 194 194 194 194 194 194 194 194 194
194 66 67 194 194 194 194 194 194 194 194 194 194 194 194 194 194 194 194 194 194 194 194 194 194 194 194 194 194 194 194 194
194 66 67 194 194 194 194 194 194 194 194 194 194 194 194 194 194 194 194 194 194 194 194 194 194 194 194 194 194 194 194 194
194 66 67 194 194 194 194 194 194 194 194 194 194 194 194 194 194 194 194 194 194 194 194 194 194 194 194 194 194 194 194 194
194 66 67 194 194 194 194 194 194 194 194 194 194 194 194 194 194 194 194 194 194 194 194 194 194 194 194 194 194 194 194 194
194 66 67 194 194 194 194 194 194 194 194 194 194 194 194 194 194 194 194 194 194 194 194 194 194 194 194 194 194 194 194 194
194 66 67 194 194 194 194 194 194 194 194 194 194 194 194 194 194 194 194 194 194 194 194 194 194 194 194 194 194 194 194 194
194 66 67 194 194 194 194 194 194 194 194 194 194 194 194 194 194 194 194 194 194 194 194 194 194 194 194 194 194 194 194 194
194 66 67 66 67 66 67 66 67 66 67 66 67 66 67 66 67 194 194 194 194 194 194 194 194 194 194 194 194 194 194 194
194 66 67 66 67 66 67 66 67 66 67 66 67 66 67 66 67 194 194 194 194 194 194 194 194 194 194 194 194 194 194 194
194 66 67 66 67 66 67 66 67 66 67 66 67 66 67 66 67 194 194 194 194 194 194 194 194 194 194 194 194 194 194 194
194 66 67 66 67 66 67 66 67 66 67 66 67 66 67 66 67 194 194 194 194 194 194 194 194 194 194 194 194 194 194 194
194 66 67 66 67 66 67 66 67 66 67 66 67 66 67 66 67 194 194 194 194 194 194 194 194 194 194 194 194 194 194 194
194 66 67 66 67 66 67 66 67 66 67 66 67 66 67 66 67 194 194 194 194 194 194 194 194 194 194 194 194 194 194 194
194 66 67 66 67 66 67 66 67 66 67 66 67 66 67 66 67 194 194 194 194 194 194 194 194 194 194 194 194 194 194 194
194 194 194 194 194 194 194 194 194 194 194 194 194 194 194 194 194 194 194 194 194 194 194 194 194 194 194 194 194 194 194 194