457 616 617 426 426 426 426 457 426 425 768 616 617 768 769 770 771 768 616 617 768 425 425 457 425 425 425 425 425 616 617 553 553 
457 648 649 818 818 818 818 457 818 818 800 648 649 800 801 802 803 800 648 649 800 847 847 457 816 752 816 752 816 648 649 553 553 
457 680 681 786 753 753 753 457 848 848 832 680 681 832 833 834 835 832 680 681 832 848 848 457 752 784 848 784 752 680 681 553 553 
457 786 785 753 784 784 784 457 848 655 864 594 594 864 594 947 594 864 594 594 864 656 848 457 784 848 784 848 784 848 784 553 553 
457 783 848 784 848 784 784 457 848 595 624 624 624 624 624 624 624 624 624 624 624 627 848 457 848 784 848 784 848 784 848 553 553 
457 783 784 848 784 848 784 457 848 687 626 626 689 624 624 624 624 624 690 626 626 688 848 457 784 848 784 848 784 848 784 553 553 
457 783 848 784 848 784 784 457 848 848 687 689 595 624 624 624 624 624 627 690 688 848 848 457 848 784 848 784 848 784 848 553 553 
553 783 784 848 784 848 784 457 848 848 848 687 687 626 626 626 626 626 688 688 848 848 848 457 784 848 784 848 784 848 784 553 553 
553 783 848 784 848 784 784 457 848 848 848 848 848 848 848 848 848 848 848 848 848 848 848 457 848 784 848 784 848 784 848 553 553 
553 783 784 848 784 848 784 483 459 459 459 459 483 848 848 848 848 848 483 425 425 425 425 483 784 848 784 848 784 848 784 553 553 
553 784 848 784 848 784 784 515 517 516 516 516 515 451 453 453 453 452 515 517 516 516 516 515 848 784 848 784 848 784 848 553 553 
553 848 784 848 784 848 784 547 816 816 816 816 515 451 453 453 453 452 515 816 816 816 816 547 784 848 784 848 784 848 784 553 553 
553 784 848 784 848 784 848 784 848 784 848 784 547 784 848 784 848 784 547 784 848 784 848 784 848 784 848 784 848 784 848 553 553 
553 848 784 848 784 848 784 848 784 848 784 848 784 848 784 848 784 848 784 848 784 848 784 848 784 848 784 848 784 848 784 553 553 
553 784 848 784 848 784 848 784 848 784 848 784 848 784 848 784 848 784 848 784 848 784 848 784 848 784 848 784 848 784 848 553 553 
553 848 784 848 784 848 784 848 784 848 784 848 784 848 784 848 784 848 784 848 784 848 784 848 784 848 784 848 784 848 784 553 553 
553 784 848 784 848 784 848 784 848 784 848 784 848 784 848 784 848 784 848 784 848 784 848 784 848 784 848 784 848 784 848 553 553 
553 848 784 848 784 848 784 848 784 848 784 848 784 848 784 848 784 848 784 848 784 848 784 848 784 848 784 848 784 848 784 553 553 
553 784 848 784 848 784 848 784 848 784 848 784 848 784 848 784 848 784 848 784 848 784 848 498 459 459 459 447 459 459 459 553 553 
553 498 426 426 415 425 425 426 425 426 425 426 458 848 784 848 784 848 784 848 784 848 784 458 821 821 821 595 627 821 821 553 553 
553 530 819 823 823 823 823 823 823 823 823 823 490 784 848 784 848 784 848 784 848 784 848 490 821 821 821 595 627 821 821 553 553 
553 530 819 821 821 821 821 821 821 821 821 821 458 848 784 848 784 848 784 848 784 848 784 490 821 821 821 595 658 656 821 553 553 
553 530 819 821 821 821 821 821 821 821 821 821 490 784 848 784 848 784 848 784 848 784 848 490 821 821 821 687 689 627 821 553 553 
553 530 819 821 821 821 821 0 821 821 821 821 458 848 784 848 784 848 784 848 784 848 784 490 821 821 821 821 595 627 821 553   553 
553 530 0 821 821 821 821 821 821 821 821 0 490 784 848 784 848 784 848 784 848 784 848 490 821 821 821 821 595 627 821 553 553    
483 461 461 461 461 483 683 683 683 683 683 582 483 848 784 848 784 848 784 848 784 848 483 582 461 461 461 582 595 627 746 483 483 
577 578 577 578 577 578 898 609 609 609 610 614 582 451 453 453 453 453 453 453 453 452 582 614 705 706 707 614 451 452 705 706 706 
609 610 609 610 609 610 930 959 959 959 959 646 614 451 453 453 453 453 453 453 453 452 614 646 737 738 739 646 451 452 737 738 738 
641 642 641 642 641 642 630 730 730 730 730 678 646 451 453 453 453 453 453 453 453 452 646 678 98 98 98 678 194 98 98 98  98     
673 674 673 674 673 674 660 725 725 725 725 710 678 451 453 453 453 453 453 453 453 452 678 710 98 194 98 710 194 98 98  98   98 
628 194 725 194 725 194 725 725 725 725 725 725 710 725 725 725 725 725 725 725 725 725 710 725 725 725 725 725 725 725 725 725 725 
628 725 725 725 725 725 725 725 725 725 725 725 725 725 725 725 725 725 725 725 725 725 725 725 725 725 725 725 725 725 725 725 725
628 725 725 725 725 725 725 725 725 725 725 725 725 725 725 725 725 725 725 725 725 725 725 725 725 725 725 725 725 725 725 725 725